0	0	0	0	2	10	2	0	1	10	1	0	1	10	1	0	
1	1	0	0	2	12	3	1	2	2	2	0	2	2	2	0	
11	2	0	0	1	2	10	2	2	10	1	0	1	10	1	0	
10	3	1	1	1	1	1	2	11	2	1	0	1	1	1	0	
11	2	1	10	1	0	0	1	1	1	1	1	1	0	1	1	
1	1	1	1	1	0	0	0	0	0	2	10	2	0	1	10	
0	0	0	1	1	1	0	0	0	0	2	11	2	0	1	1	
0	0	0	1	10	1	1	2	2	1	1	2	2	1	0	0	
1	1	1	2	3	2	2	11	10	2	1	2	10	1	0	0	
10	2	3	10	3	10	3	3	3	3	11	4	2	1	0	0	
3	12	3	11	3	1	2	11	2	3	10	12	2	0	1	1	
10	2	2	1	1	0	1	2	10	2	3	12	2	0	1	10	
1	1	0	0	0	0	0	1	1	2	2	2	1	1	3	3	
0	0	0	0	1	1	1	0	0	1	10	2	1	3	10	11	
2	2	1	0	1	10	1	0	0	1	1	2	10	3	12	3	
11	10	1	0	1	1	1	0	0	0	0	1	1	2	1	1	
